Year;Month;Day;Level of affectedness
2018;1;1;0
2018;2;1;0
2018;3;1;0
2018;4;1;0
2018;5;1;0
2018;6;1;0
2018;7;1;0
2018;8;1;0
2018;9;1;0
2018;10;1;0
2018;11;1;0
2018;12;1;0
2019;1;1;0
2019;2;1;0
2019;3;1;0
2019;4;1;0
2019;5;1;0
2019;6;1;0
2019;7;1;0
2019;8;1;0
2019;9;1;0
2019;10;1;0
2019;11;1;0
2019;12;1;0
2020;1;1;0
2020;2;1;0
2020;3;1;3
2020;4;1;3
2020;5;1;1
2020;6;1;1
2020;7;1;1
2020;8;1;2
2020;9;1;2
2020;10;1;1
2020;11;1;1
2020;12;1;2
2021;1;1;2
2021;2;1;1
2021;3;1;0
